0,0,0,1,1,0,0,0,0,3,8,8,8,8,9
0,0,1,1,2,1,0,0,0,3,7,8,8,8,9
0,0,1,1,2,1,0,0,0,3,7,7,8,8,8
0,0,0,1,1,1,0,0,26,26,7,7,7,8,8
0,0,0,0,0,0,0,26,26,0,10,7,7,8,8
0,0,0,0,0,0,0,5,0,0,7,7,7,8,8
0,0,0,0,0,0,0,3,0,0,0,10,7,7,7
25,25,25,25,25,25,25,26,0,0,0,10,7,7,7
0,0,0,0,0,0,0,0,0,0,4,10,7,7,7
0,0,0,0,0,0,0,0,0,0,0,1,0,7,7
0,0,0,0,0,0,0,0,0,4,0,0,0,0,7