9,9,9,9,9,9,9,9,9,9,9,9,9,9,9
9,9,1,1,1,1,2,2,2,2,2,9,9,9,9
9,4,1,1,1,1,2,2,2,9,9,9,8,9,9
9,0,0,1,1,1,0,0,2,2,9,9,9,8,8
0,0,0,0,0,0,0,0,2,2,10,9,9,8,8
0,0,0,0,0,0,0,7,7,7,7,7,7,7,7
0,0,0,0,0,0,0,0,0,0,0,10,9,9,9
0,0,0,0,0,0,0,0,0,0,0,10,9,9,9
1,1,1,1,2,2,2,2,2,2,4,10,9,9,9
1,1,9,9,9,9,9,9,9,9,9,9,9,9,9
1,9,9,9,9,9,9,9,9,9,9,9,9,9,9
