2,2,2,2,2,0,0,0,0,0,0,7,9,9,9
0,2,2,4,0,0,26,26,0,4,0,7,4,9,9
0,0,0,0,0,0,26,26,0,0,7,7,7,7,9
0,0,0,0,0,4,0,0,0,0,7,7,7,7,7
0,0,0,0,0,0,0,0,0,4,7,7,4,7,7
0,0,0,0,0,0,0,0,0,0,7,7,7,7,7
0,0,0,0,4,0,0,0,0,0,0,0,7,7,7
0,0,0,0,0,0,0,0,4,0,0,0,0,7,9
0,0,0,0,0,0,0,0,0,0,0,0,0,9,9
0,0,0,0,4,0,0,0,0,0,0,0,0,4,9
0,0,0,0,0,0,0,0,0,0,0,0,9,9,9