6,6,6,6,6,6,6,6,6,6,6,6,6,6,6
0,0,0,0,0,0,0,0,0,0,0,7,7,7,7
0,0,0,4,0,0,0,0,0,4,0,7,4,7,7
0,0,0,0,0,0,0,0,0,0,7,7,7,7,7
0,0,0,0,0,4,0,0,0,0,7,7,7,7,7
0,0,0,0,0,0,0,0,0,4,7,7,4,7,7
0,0,0,0,0,0,0,0,0,0,7,7,7,7,7
0,0,0,0,4,0,0,0,0,0,0,0,7,7,7
0,0,0,0,0,0,0,0,4,0,0,0,0,7,7
0,0,0,0,0,0,0,0,0,0,0,0,0,7,7
0,0,0,0,4,0,0,0,0,0,0,0,0,4,7
0,0,0,0,0,0,0,0,0,0,0,0,0,0,7