7,7,11,11,7,7,7,7,3,7,11,7,7,7,7
7,7,11,11,7,7,7,7,5,7,18,7,7,7,7
7,7,11,7,7,7,7,26,3,7,18,10,7,7,7
7,7,18,7,7,7,26,26,7,7,18,7,7,7,7
7,7,18,7,7,7,3,11,7,22,20,20,11,11,7
7,7,18,10,7,8,3,8,8,18,7,7,7,11,7
7,7,18,7,7,8,3,8,11,11,7,10,7,11,7
7,7,18,7,7,8,3,8,8,18,7,7,7,7,9
7,7,11,11,8,3,26,7,7,11,11,7,7,9,9
7,7,11,11,20,5,20,20,20,24,7,7,9,9,9
7,10,7,11,7,3,7,7,7,7,7,7,9,9,9
