7,7,11,11,7,7,7,7,3,7,11,7,7,7,7
7,7,11,11,7,7,7,7,5,7,7,7,7,7,7
7,7,11,7,7,7,7,3,3,7,7,10,7,7,7
7,7,7,7,7,7,3,3,7,7,7,7,7,7,7
7,7,7,7,7,7,3,11,7,7,7,7,11,11,7
7,7,7,10,7,8,3,8,8,7,7,7,7,11,7
7,7,7,7,7,8,3,8,11,11,7,10,7,11,7
7,7,7,7,7,8,3,8,8,7,7,7,7,7,9
7,7,11,11,8,3,8,7,7,11,11,7,7,9,9
7,7,11,11,7,5,7,7,7,7,7,7,9,9,9
7,10,7,11,7,3,7,7,7,7,7,7,9,9,9
