7,7,7,7,7,18,7,7,7,7,7,7,9,2,2
7,7,10,7,7,18,10,3,3,3,26,9,2,2,0
7,26,3,3,3,12,3,3,13,13,3,2,0,0,0
7,3,13,11,11,12,11,11,11,8,3,0,0,0,0
7,3,13,11,11,11,11,11,7,7,5,20,20,23,0
20,5,7,7,7,11,11,7,8,8,3,0,0,18,0
7,3,8,8,8,7,7,7,26,3,26,1,0,18,0
9,3,8,3,3,3,13,13,3,0,0,0,0,18,0
9,26,3,26,0,26,3,3,26,0,0,0,0,18,0
2,2,2,0,0,0,0,0,0,0,0,0,0,18,0
2,2,2,0,0,0,0,0,1,0,0,0,0,18,0