7,7,7,3,7,7,0,0,0,0,0,0,0,0,0
7,11,11,3,3,13,7,0,0,0,0,0,0,1,0
7,11,11,11,5,13,13,0,0,0,0,1,0,0,0
7,18,7,11,3,3,3,10,7,7,0,0,0,0,0
7,18,13,7,13,7,26,3,9,9,9,10,7,0,0
7,11,7,13,7,7,7,26,3,9,9,9,9,7,9
11,11,11,20,20,23,7,7,26,26,25,25,25,12,25
11,11,7,10,9,18,7,7,11,3,9,9,9,7,7
7,10,9,9,7,18,7,11,11,3,3,9,9,7,7
9,9,9,7,7,21,20,20,11,11,5,13,13,7,7
9,9,7,7,7,7,7,11,11,13,26,3,7,7,7