7,7,7,3,7,7,0,0,0,0,0,0,0,0,0
7,11,11,3,3,13,7,0,0,0,0,0,0,1,0
7,11,11,11,5,13,13,0,0,0,0,1,0,0,0
7,7,7,11,3,3,3,10,7,7,0,0,0,0,0
7,7,13,7,13,7,3,3,9,9,9,10,7,0,0
7,11,7,13,7,7,7,3,3,9,9,9,9,7,9
11,11,11,13,7,7,7,7,3,3,3,3,3,12,3
11,11,7,10,9,7,7,7,11,3,9,9,9,7,7
7,10,9,9,7,7,7,11,11,3,3,9,9,7,7
9,9,9,7,7,7,7,7,11,11,5,13,13,7,7
9,9,7,7,7,7,7,11,11,13,3,3,7,7,7