17,17,17,16,17,17,17,16,16,17,17,17,17,17,17
17,17,17,16,16,16,16,16,16,16,16,16,16,16,17
17,16,16,16,17,16,17,17,17,17,16,16,16,17,17
17,16,17,17,17,17,17,17,17,17,17,17,16,16,17
17,16,17,17,17,16,16,16,16,16,16,17,17,16,17
16,16,17,17,16,16,16,16,16,16,16,16,22,20,14
20,20,20,20,23,11,16,16,16,16,16,16,18,16,16
16,16,16,16,18,11,11,22,20,20,20,20,24,17,17
17,16,16,16,21,20,20,24,16,16,16,16,16,16,17
17,17,16,17,16,17,17,17,16,16,17,16,17,17,17
17,17,17,17,17,17,17,17,17,17,17,17,17,17,17