26,26,26,26,26,26,9,11,7,26,26,26,26,26,26
26,9,8,0,26,26,0,4,7,26,26,26,26,26,26
26,9,11,0,26,26,26,18,26,26,26,26,26,26,26
26,7,7,7,4,26,26,18,26,26,26,26,26,26,26
26,0,7,7,4,20,20,24,20,20,20,20,23,0,0
26,26,26,0,0,26,18,26,26,26,26,26,18,7,7
26,26,26,26,26,26,18,26,26,26,26,0,18,7,9
26,26,26,26,26,26,18,26,26,26,0,0,18,7,9
0,0,0,0,26,26,18,20,20,20,20,20,23,7,7
11,7,4,20,20,20,24,26,26,0,0,7,11,11,7
7,7,4,0,26,26,26,26,26,0,7,7,11,11,7